xxxxxxxxxxxxxxxxxxxxxxxxxxxxxxxxxxxxxxxx
xD                                     x
x    ttttttttt                         x
x    t       t                         x
x    h       t                         x
x            t                         x
x            t                         x
x            t                         x
x                                      x
x                                      x
x                                      x
x                                      x
x                                      x
x                                      x
x                                      x
x                                      x
x                                      x
x                                      x
x                                      x
x                                      x
x                                      x
x       xxxxxxxxxxx                    x
x                                      x
x                                      x
x                                      x
x                                      x
x                                      x
x                                      x
x                                      x
xxxxxxxxxxxxxxxxxxxxxxxxxxxxxxxxxxxxxxxx